3333333333333333333333
3002266622066666622503
3000066600000000000003
3000221210021212004203
3000120000000000000403
3000000000000000000203
3000021200121212101203
3000022000002210000403
3000012000002211771503
3000121210021212121103
3001552100000000066003
3002777710000000006003
3001177500012120014203
3001275100000000002103
3000151210000000042103
3000021210001212004403
3000220000000017772003
3000120002200021112203
3000000000000000000003
3333333333333333333333